11111111111111111
11111111111111111
11111111111111111
11111111111111111
11111111111111111
1P0000C00C00000E1
11111111111111111
11111111111111111
