11111111111111
1P00C000C000E1
10M000M000M001
11111111111111
