11111111111
10000000111
11101110111
1C010000111
1C011110011
1C00000E0P1
11101100011
1C000000C11
1C011101C11
11111111111