111111111111111111111111111111
10E000000000000000000000000001
1P1111010010000010100100010101
101111001010101000100100010101
100000000000000000000000100001
101111010010000C10100100010101
101111001010101000100100010101
101111010010000010100100010101
101111001010101000100100010101
101111010010000010100100010101
101111001010101000100100010101
111111111111111111111111111111
111111111111111111111111111111
111111111111111111111111111111
111111111111111111111111111111
