111111111111111111111111
1C00C0P100000001000100C1
10111111000100010C010111
1000000C00010001000100E1
111011011111001110010111
10001000C100000C00110001
101111111100011110010001
10000010C00001C010010111
10C0C010000C010000000001
111111111111111111111111
