1111111111
1111111111
1P0CE100C1
1111111111
1111111111
