1111111111
1111111111
1P0C10E0C1
1111111111
1111111111
