111111111111
100C0100P001
101001000C01
1C0010000001
10010C0E0C01
111111111111
