1111111111
1P00000011
1110111011
1C01000011
1C011110E1
1C00M00001
1110111011
1C000000C1
10M11101C1
100000M001
1111111111
