111111111111111111111111111111
1E0000000M00M000C00000C0000001
101111010010000010100100000101
101111001010101000100100000101
1P0000000C00C000M00000001C1001
101111010010000010100100000101
101111001M10101000100100000101
101111010010000010100100000101
111111111111111111111111111111
