1111111111
1111111111
1MPC00E001
1111111111
1111111111
